XXXXXXXXXXXXX
X         O X
X     X   D X
X    X      X 
X   X       X
X           X
X           X
XXXXXXXXXXXXX