XXXXXXXXXXXXX
X         O X
      X   D X
X    X      X 
X   X       X
X           
X           X
XXXXXXX XXX X